NO ./assets/textures/blue_block.xpm
SO ./assets/textures/red_block.xpm
EA ./assets/textures/purple_block.xpm
WE ./assets/textures/brick_block.xpm

F 111,110,111
C 57,56,57

                      111111111111111111
                 111111000000000000000011111
              111100000000000000000000000001111
            1110000000000000000000000000000000111
          11100000000001111111111111110000000000111
         110000000000111             111000000000011
        11000000000111                 11100000000011
       1100000000011                     1100000000011
       100000000011                       110000000001
       10000000001                         10000000001
       10000000001                         10000000001
       10000000001                         10000000001
       100000000011                       110000000001
       1000000000011                     1100000000001
       110000000000111                 111000000000011
        1100000000000111             1110000000000011
         1100000000000011111111111111100000000000011
          111E0000000000000000000000000000000000111
            1110000000000000000000000000000000111
              111100000000000000000000000001111
                 111111000000000000000111111
                      11111111111111111
