NO ./assets/textures/blue_block.xpm
SO ./assets/textures/red_block.xpm
EA ./assets/textures/purple_block.xpm
WE ./assets/textures/brick_block.xpm

F 111,110,111
C 57,56,57

                                         11111
                                        11000111111111
11111111111111111                       11000000000001
100000000000000011111111111111111111111111000000000001
1000000000000000000000000000000000000000000000000000W1
100000000000000011111111111111111111111111111111111111
10000000000000001
10000000000000001
10000000000000001
10000000000000001
10000000000000001
10000000000000001
10000000000000001
10000000000000001
11111011111111111
    101
11111011111111111
10000000000000001
10000000000000001
10000000000000001
10000000000000001
10000000000000001
10000000000000001
10000000000000001
10000000000000001
10000000000000001
10000000000000001
10000000000000001
11111111111111111
