NO ./assets/textures/blue_block.xpm
SO ./assets/textures/red_block.xpm
EA ./assets/textures/purple_block.xpm
WE ./assets/textures/brick_block.xpm

F 111,110,111
C 57,56,57

       1111111111111111111111111111        111111111111111111111111111111111
1111111100S00000000000000000001111111      100000000000000000000000000000011111111111
1100000000000000000000000000000001    11111110000000000000000000000000000011111111
110000000000000111111111111111111111111000000000000000000000000000001111111111111
111110000000000111111111111111111111110000000000000000000000000000011
11111111111000000000000000000000000000000000000000000001111111111111
1111011111110000000000000000000000000000000000000000000011111
1111111111111000000000000000000000001111110111110000000001111
            110000000000000000000000100000000001000000000001111
            111000000000000000000000100000000001000000000001111
            111100000000000000000000111111111111000000000000111
            111110000000000000000000000000000000000000000000011
               11100000000000000000000000000000011111111111111111
                111000000000000000000000000000000000000000000001111
                 1110000000000000000000000000000000000000000000011111111111
                 1111000000000000000000000000000000000000000000001111111111
            111111111100000000000000000000000000000000000000000000111111111
11111111111110000000000000000000000000000000000000000000000111111111111111
1111000000000001111110000000000000000000000000000000000000000000011111111111111
1111000000000000000111111000000000000000000000000000000000000000000000000111111111111
11110000000000000001111111100000000000000000000000000001111111111111111111111
11110000000000000001111111100000000000000000000000000011
1111111111101111111111111111000000000000000000011111111111
11111000000000000001111111111000000000000000001011111
11110000000000000000000000000000000000000000000101111
11110000000000000001111111111111111111111111111111
11111111111111111111111111
